CAENORHABDITISELEGANSSTRAINN2	caenorhabditis_elegans_strain_n2
PILIOCOLOBUSTEPHROSCELES	piliocolobus_tephrosceles
PERIOPHTHALMUSMAGNUSPINNATUS	periophthalmus_magnuspinnatus
PERIOPHTHALMUSMAGNUSPINNATUS	periophthalmus_magnuspinnatus
POECILIAFORMOSA	poecilia_formosa
POECILIAMEXICANA	poecilia_mexicana
POECILIALATIPINNA	poecilia_latipinna
POECILIARETICULATA	poecilia_reticulata
XIPHOPHORUSMACULATUS	xiphophorus_maculatus
XIPHOPHORUSCOUCHIANUS	xiphophorus_couchianus
GAMBUSIAAFFINIS	gambusia_affinis
CYPRINODONVARIEGATUS	cyprinodon_variegatus
FUNDULUSHETEROCLITUS	fundulus_heteroclitus
KRYPTOLEBIASMARMORATUS	kryptolebias_marmoratus
ORYZIASLATIPES	oryzias_latipes
ORYZIASLATIPESASM223469V1	oryzias_latipes_asm223469v1
ORYZIASLATIPES	oryzias_latipes
ORYZIASMELASTIGMA	oryzias_melastigma
MOLAMOLA	mola_mola
TAKIFUGURUBRIPES	takifugu_rubripes
TETRAODONNIGROVIRIDIS	tetraodon_nigroviridis
MOLAMOLA	mola_mola
GASTEROSTEUSACULEATUS	gasterosteus_aculeatus
LABRUSBERGYLTA	labrus_bergylta
MONOPTERUSALBUS	monopterus_albus
MASTACEMBELUSARMATUS	mastacembelus_armatus
ANABASTESTUDINEUS	anabas_testudineus
SCOPHTHALMUSMAXIMUS	scophthalmus_maximus
CYNOGLOSSUSSEMILAEVIS	cynoglossus_semilaevis
SERIOLADUMERILI	seriola_dumerili
SERIOLALALANDIDORSALIS	seriola_lalandi_dorsalis
AMPHIPRIONPERCULA	amphiprion_percula
AMPHIPRIONOCELLARIS	amphiprion_ocellaris
ACANTHOCHROMISPOLYACANTHUS	acanthochromis_polyacanthus
STEGASTESPARTITUS	stegastes_partitus
ASTATOTILAPIACALLIPTERA	astatotilapia_calliptera
HAPLOCHROMISBURTONI	haplochromis_burtoni
PUNDAMILIANYEREREI	pundamilia_nyererei
MAYLANDIAZEBRA	maylandia_zebra
NEOLAMPROLOGUSBRICHARDI	neolamprologus_brichardi
OREOCHROMISNILOTICUS	oreochromis_niloticus
AMPHILOPHUSCITRINELLUS	amphilophus_citrinellus
HIPPOCAMPUSCOMES	hippocampus_comes
GADUSMORHUA	gadus_morhua
ESOXLUCIUS	esox_lucius
PYGOCENTRUSNATTERERI	pygocentrus_nattereri
ASTYANAXMEXICANUS	astyanax_mexicanus
ICTALURUSPUNCTATUS	ictalurus_punctatus
ASTYANAXMEXICANUS	astyanax_mexicanus
DANIORERIO	danio_rerio
SCLEROPAGESFORMOSUS	scleropages_formosus
PARAMORMYROPSKINGSLEYAE	paramormyrops_kingsleyae
LEPISOSTEUSOCULATUS	lepisosteus_oculatus
NOTECHISSCUTATUS	notechis_scutatus
NOTECHISSCUTATUS	notechis_scutatus
POGONAVITTICEPS	pogona_vitticeps
ANOLISCAROLINENSIS	anolis_carolinensis
SALVATORMERIANAE	salvator_merianae
SPHENODONPUNCTATUS	sphenodon_punctatus
LONCHURASTRIATADOMESTICA	lonchura_striata_domestica
LONCHURASTRIATADOMESTICA	lonchura_striata_domestica
TAENIOPYGIAGUTTATA	taeniopygia_guttata
SERINUSCANARIA	serinus_canaria
FICEDULAALBICOLLIS	ficedula_albicollis
PARUSMAJOR	parus_major
CYANISTESCAERULEUS	cyanistes_caeruleus
JUNCOHYEMALIS	junco_hyemalis
ZONOTRICHIAALBICOLLIS	zonotrichia_albicollis
LEPIDOTHRIXCORONATA	lepidothrix_coronata
MANACUSVITELLINUS	manacus_vitellinus
CALIDRISPYGMAEA	calidris_pygmaea
CALIDRISPYGMAEA	calidris_pygmaea
CALIDRISPUGNAX	calidris_pugnax
MELOPSITTACUSUNDULATUS	melopsittacus_undulatus
ANSERBRACHYRHYNCHUS	anser_brachyrhynchus
ANASPLATYRHYNCHOSPLATYRHYNCHOS	anas_platyrhynchos_platyrhynchos
MELEAGRISGALLOPAVO	meleagris_gallopavo
COTURNIXJAPONICA	coturnix_japonica
GALLUSGALLUS	gallus_gallus
NUMIDAMELEAGRIS	numida_meleagris
APTERYXHAASTII	apteryx_haastii
APTERYXOWENII	apteryx_owenii
APTERYXROWI	apteryx_rowi
DROMAIUSNOVAEHOLLANDIAE	dromaius_novaehollandiae
NOTHOPROCTAPERDICARIA	nothoprocta_perdicaria
CROCODYLUSPOROSUS	crocodylus_porosus
CHELONOIDISABINGDONII	chelonoidis_abingdonii
GOPHERUSAGASSIZII	gopherus_agassizii
CHRYSEMYSPICTABELLII	chrysemys_picta_bellii
PELODISCUSSINENSIS	pelodiscus_sinensis
PHASCOLARCTOSCINEREUS	phascolarctos_cinereus
NOTAMACROPUSEUGENII	notamacropus_eugenii
SARCOPHILUSHARRISII	sarcophilus_harrisii
MONODELPHISDOMESTICA	monodelphis_domestica
NOMASCUSLEUCOGENYS	nomascus_leucogenys
PONGOABELII	pongo_abelii
PANTROGLODYTES	pan_troglodytes
PANTROGLODYTES	pan_troglodytes
PANPANISCUS	pan_paniscus
HOMOSAPIENS	homo_sapiens
GORILLAGORILLA	gorilla_gorilla
NOMASCUSLEUCOGENYS	nomascus_leucogenys
PANTROGLODYTES	pan_troglodytes
CERCOCEBUSATYS	cercocebus_atys
MANDRILLUSLEUCOPHAEUS	mandrillus_leucophaeus
PAPIOANUBIS	papio_anubis
THEROPITHECUSGELADA	theropithecus_gelada
MACACAMULATTA	macaca_mulatta
MACACAFASCICULARIS	macaca_fascicularis
CHLOROCEBUSSABAEUS	chlorocebus_sabaeus
RHINOPITHECUSROXELLANA	rhinopithecus_roxellana
COLOBUSANGOLENSISPALLIATUS	colobus_angolensis_palliatus
PONGOABELII	pongo_abelii
PONGOABELII	pongo_abelii
MACACANEMESTRINA	macaca_nemestrina
RHINOPITHECUSBIETI	rhinopithecus_bieti
GORILLAGORILLA	gorilla_gorilla
CEBUSCAPUCINUS	cebus_capucinus
SAIMIRIBOLIVIENSISBOLIVIENSIS	saimiri_boliviensis_boliviensis
CALLITHRIXJACCHUS	callithrix_jacchus
AOTUSNANCYMAAE	aotus_nancymaae
CARLITOSYRICHTA	carlito_syrichta
PROPITHECUSCOQUERELI	propithecus_coquereli
PROLEMURSIMUS	prolemur_simus
MICROCEBUSMURINUS	microcebus_murinus
OTOLEMURGARNETTII	otolemur_garnettii
DIPODOMYSORDII	dipodomys_ordii
CASTORCANADENSIS	castor_canadensis
MICROTUSOCHROGASTER	microtus_ochrogaster
JACULUSJACULUS	jaculus_jaculus
MUSSPICILEGUS	mus_spicilegus
MUSSPRETUSSTRAINSPRETEIJ	mus_spretus_strain_spret/eij
MUSMUSCULUS	mus_musculus
MUSCAROLISTRAINCAROLIEIJ	mus_caroli_strain_caroli_eij
MUSPAHARI	mus_pahari
RATTUSNORVEGICUS	rattus_norvegicus
MERIONESUNGUICULATUS	meriones_unguiculatus
NANNOSPALAXGALILI	nannospalax_galili
CRICETULUSGRISEUSCHOK1GSHD	cricetulus_griseus_chok1gshd
CRICETULUSGRISEUSCRIGRIPICR	cricetulus_griseus_crigri-picr
CRICETULUSGRISEUSCRIGRI	cricetulus_griseus_crigri
MESOCRICETUSAURATUS	mesocricetus_auratus
PEROMYSCUSMANICULATUSBAIRDII	peromyscus_maniculatus_bairdii
JACULUSJACULUS	jaculus_jaculus
HETEROCEPHALUSGLABERFEMALE	heterocephalus_glaber_female
HETEROCEPHALUSGLABERMALE	heterocephalus_glaber_male
FUKOMYSDAMARENSIS	fukomys_damarensis
CAVIAPORCELLUS	cavia_porcellus
CAVIAAPEREA	cavia_aperea
OCTODONDEGUS	octodon_degus
CHINCHILLALANIGERA	chinchilla_lanigera
MUSSPRETUSSTRAINSPRETEIJ	mus_spretus_strain_spret/eij
MUSCAROLISTRAINCAROLIEIJ	mus_caroli_strain_caroli_eij
MUSMUSCULUS	mus_musculus
MUSPAHARI	mus_pahari
SPERMOPHILUSDAURICUS	spermophilus_dauricus
UROCITELLUSPARRYII	urocitellus_parryii
ICTIDOMYSTRIDECEMLINEATUS	ictidomys_tridecemlineatus
MARMOTAMARMOTAMARMOTA	marmota_marmota_marmota
ORYCTOLAGUSCUNICULUS	oryctolagus_cuniculus
OCHOTONAPRINCEPS	ochotona_princeps
CAPRAHIRCUS	capra_hircus
OVISARIES	ovis_aries
BOSTAURUS	bos_taurus
BOSMUTUS	bos_mutus
BISONBISONBISON	bison_bison_bison
TURSIOPSTRUNCATUS	tursiops_truncatus
SUSSCROFA	sus_scrofa
SOREXARANEUS	sorex_araneus
ERINACEUSEUROPAEUS	erinaceus_europaeus
URSUSMARITIMUS	ursus_maritimus
URSUSAMERICANUS	ursus_americanus
AILUROPODAMELANOLEUCA	ailuropoda_melanoleuca
NEOVISONVISON	neovison_vison
MUSTELAPUTORIUSFURO	mustela_putorius_furo
CANISLUPUSFAMILIARIS	canis_lupus_familiaris
CANISLUPUSDINGO	canis_lupus_dingo
VULPESVULPES	vulpes_vulpes
PANTHERAPARDUS	panthera_pardus
PANTHERATIGRISALTAICA	panthera_tigris_altaica
FELISCATUS	felis_catus
EQUUSASINUSASINUS	equus_asinus_asinus
EQUUSCABALLUS	equus_caballus
PTEROPUSVAMPYRUS	pteropus_vampyrus
MYOTISLUCIFUGUS	myotis_lucifugus
LOXODONTAAFRICANA	loxodonta_africana
PROCAVIACAPENSIS	procavia_capensis
ECHINOPSTELFAIRI	echinops_telfairi
DASYPUSNOVEMCINCTUS	dasypus_novemcinctus
CHOLOEPUSHOFFMANNI	choloepus_hoffmanni
ORNITHORHYNCHUSANATINUS	ornithorhynchus_anatinus
ORNITHORHYNCHUSANATINUS	ornithorhynchus_anatinus
XENOPUSTROPICALIS	xenopus_tropicalis
LATIMERIACHALUMNAE	latimeria_chalumnae
EPTATRETUSBURGERI	eptatretus_burgeri
PETROMYZONMARINUS	petromyzon_marinus
CIONAINTESTINALIS	ciona_intestinalis
CIONASAVIGNYI	ciona_savignyi
DROSOPHILAMELANOGASTER	drosophila_melanogaster
PILIOCOLOBUSTEPHROSCELES	piliocolobus_tephrosceles
PONGOABELII	pongo_abelii
SACCHAROMYCESCEREVISIAE	saccharomyces_cerevisiae
